10,10
1,2,1,1,1,1,1,1,1,1
1,0,1,0,0,0,0,0,0,1
1,0,0,0,0,0,0,0,1,1
1,0,0,0,0,0,0,0,0,2
1,0,0,0,0,0,0,0,1,1
1,0,0,0,0,0,0,0,0,1
1,0,0,0,0,0,0,0,0,1
1,0,0,0,0,0,0,1,1,1
1,0,0,0,0,0,0,0,0,1
1,1,1,1,1,1,1,1,1,1
0,1,9,9,6,0,1,-1,0